00000000000000000000000000000000000000000000000000000000000000000000000000000000000000000000000000000000000000000000000000000000000000000000000000000000000000000000000000000000000000000000000000000000000000000000000000000000
00000000000000000000000000000000000000000000000000000000000000000000000000000000000000000000000000000000000000000000000000000000000000000000000000000000000000000000000000000000000000000000000000000000000000000000000000000000
000000000000000000000000000000000000000000000000000000000000000000000000000000000000000000000000000000000000000000000000000000000000000000000000000000000000000000000000000000000000000000000000000000E0000000000000000000000000
000000000000000000000000000000000000000000000000000000000000000000000000000000000000000000000000000000000000000000000000000000000000000000000000000000000000000000000000000000000000000000000000000000F0000000000000000000000000
00000000000000000000000000000000000000000000000000000000000000000000000000000000G0G0000000000000000000000000000000000000000000000000000000000000000000000000000000000000000000000000000000000000000000F0000000000000000000000000
000000000000000000000060000000000000000000000000000000000000000000000000000000003333333300033360000000000000070000000000033300003663000000000000000000000000000000000000000000000000000000002200000000F0000000000000000000000000
000000000000000000000000000000000000000000000000000000000000000000000000000000000000000000000000000000000000000000000000000000000000000000000000000000000000000000000000000000000000000000022200000000F0000000000000000000000000
000000000000000000000000000000000000000000000000000000000000000000000000000000000000000000000000000000000000000000000000000000000000000000000000000000000000000000000000000000000000000000222200000000F0000000000000000000000000
000000000000000000000000000000000000000000000000000000000000000008000000000000000000000000000000000000000000000000000000000000000000000000000000000000000000000000000000000000000000000002222200000000F0000000000000000000000000
00000000000000006000373630000000000000000000000AB000000000AB000000000000000003730000000000000040000035000060060060000030000000000330000002002000000000022002000000000000336300000000000022222200000000F0000000000000000000000000
00000000000000000000000000000000000000AB0000000CD000000000CD000000000000000000000000000000000000000000000000000000000000000000000000000022002200000000222002200000000000000000000000000222222200000000F0000000000000000000000000
0000000000000000000000000000AB00000000CD0000000CD000000000CD0000000000000000000000000000000000000000000000000000000000000000000000000002220022200000022220022200000AB00000000000000AB02222222200000000F0000000000000000000000000
00000000000000000000G0000000CD00000000CDG000000CD000GG0000CD0000000000000000000000000000000000000G0G0000000T000000G0G0000000G0G0G0G00022220022220000222220022220000CD000000000G0G00CD2222222220000000020000000000000000000000000
11111111111111111111111111111111111111111111111111111111111111111111100111111111111111000111111111111111111111111111111111111111111111111111111111111111100111111111111111111111111111111111111111111111111111111111111111111111
11111111111111111111111111111111111111111111111111111111111111111111100111111111111111000111111111111111111111111111111111111111111111111111111111111111100111111111111111111111111111111111111111111111111111111111111111111111